0000000111110000000000000000
0000000122210000000000000000
0000000122210000000011111100
0000000122210000000012222100
0000000012210000000012222100
0000000012210001111112222100
0000000012211112222222222100
0000000012222222222222222100
1111111112111112211111112100
1222222222100012210000012100
1222222222101112211111012100
1222221111210122222222122100