000000000000000000000000000000
000000001111100000000000000000
000000001222100000000111111000
000000001222100000000122221000
000000001222100000000122221000
000000000122100011111122221000
000000000122111122222222221000
000000000122222222222222221000
011111111121111122111111121000
012222222221000122100000121000
012222222221011122111110121000
012222111121012222222221121000
012111000121012322222222221000
012100000121012222222322121110
012100000121112222222222122210
012100000122222222224422122210
012100000121112222224422144210
012100000121012232222222144210
012111111121012222222222122210
012222222221012222232222122210
011111111121012222222222122310
000000000121012111111121132210
000000000121012100000121012100
000000000121112100000121122100
000000000122222100111121121000
000000000122222100122221121100
000000000122222111124421122210
000000000122222222224421111210
000000000122222111122222222210
000000000111111100111111111110